[
    "KT-201",
    "KT-208",
    "KT-213",
    "KT-216",
    "KT-217",
    "KT-218",
    "KT-219",
    "KT-220",
    "KT-221",
    "KT-222",
    "KT-223",
    "KT-224",
    "KT-302",
    "KT-303",
    "KT-304",
    "KT-305",
    "KT-306",
    "KT-307",
    "KT-318(A)",
    "KT-318(B)",
    "KT-320",
    "KT-801(A)",
    "KT-801(B)",
    "KT-802",
    "KT-803",
    "KT-804",
    "KT-813(B)",
    "KT-514",
    "KT-515",
    "KT-516",
    "KT-518",
    "KT-916"
]